{
    "mapWidth": 10, 
    "mapHeight": 10, 
    "tileWidth": 64, 
    "tileHeight": 64,
    "tileSources": {"1":"Assets/GrassTile.png","2":"Assets/Basic Enemy White 2.png", "3":"Assets/Basic Enemy White 3.png"},
    "tilemapString": 
    [
        "1", "1", "1", "1", "1", "1", "1", "1", "1", "1", 
        "1", "1", "1", "1", "1", "1", "1", "1", "1", "1",
        "1", "1", "1", "1", "1", "1", "1", "1", "1", "1",
        "1", "1", "1", "1", "1", "1", "1", "1", "1", "1", 
        "1", "1", "1", "1", "1", "1", "1", "1", "1", "1",
        "1", "1", "1", "1", "1", "1", "1", "1", "1", "1",
        "1", "1", "1", "1", "1", "1", "1", "1", "1", "1", 
        "1", "1", "1", "1", "1", "1", "1", "1", "1", "1",
        "1", "1", "1", "1", "1", "1", "1", "1", "1", "1",
        "1", "1", "1", "1", "1", "1", "1", "1", "1", "1"
    ]
}